43 43 43 43 43 43 43 43 43 43 43 43 43 43 43 43 43 43 43 43 43 43 43 43 43 43 43 43 43 43 43 43 43 43 43 43 43 43 43 43 43 43 43 43 43 43 43 43 43 43 43 43 43 43 43 43 43 43 43 43 43 43 43 43 43 43 43 43 43 43 
43 43 43 43 43 43 43 43 43 43 43 43 43 66 66 43 43 43 43 43 43 43 43 43 43 43 43 43 43 43 43 43 43 66 66 66 66 66 66 66 66 66 66 66 66 66 66 66 43 43 43 43 43 43 43 43 43 43 43 43 43 43 43 43 43 43 43 43 43 43 
43 43 43 43 43 43 43 43 43 43 43 43 43 43 66 66 66 43 38 39 39 39 39 39 40 43 43 43 43 38 39 39 39 39 39 39 39 39 39 39 39 39 39 39 39 39 39 39 39 39 39 39 39 39 39 39 39 39 40 43 43 43 43 43 43 43 43 43 43 43 
43 43 43 43 43 43 43 43 43 43 43 43 43 43 43 43 66 66 50 51 51 51 51 51 52 43 43 43 43 50 51 51 51 51 51 51 51 51 51 51 51 51 51 51 51 51 51 51 51 51 51 51 51 51 51 51 51 51 52 43 43 43 43 43 43 43 43 43 43 43 
43 43 43 43 43 43 66 66 66 43 43 43 43 43 43 43 43 43 50 51 51 51 51 51 52 65 65 65 65 50 51 51 51 51 51 73 51 51 51 51 51 51 51 51 51 51 51 51 51 51 51 51 51 51 51 51 51 51 52 43 43 43 43 43 43 43 43 43 43 43 
43 43 43 43 66 66 66 38 39 39 39 39 39 39 39 40 43 43 50 51 51 51 51 51 52 65 65 65 65 50 51 51 51 51 51 51 51 51 51 51 51 51 51 51 51 51 51 51 51 73 51 51 51 51 51 51 51 51 52 43 43 43 43 43 43 43 43 43 43 43 
43 43 43 66 66 43 43 50 51 51 37 37 49 37 61 52 43 43 50 51 51 51 112 51 52 43 43 43 43 50 51 51 51 51 51 51 51 51 51 51 51 51 51 51 51 51 51 51 51 51 51 51 51 51 51 51 51 51 52 43 43 43 43 43 43 43 43 43 43 43 
43 43 43 66 43 43 43 50 37 37 61 37 49 51 51 52 43 43 50 51 51 51 112 51 52 43 43 43 43 50 51 51 51 51 51 51 51 51 51 51 51 51 51 51 51 51 51 51 51 51 51 51 51 51 51 51 51 51 52 43 43 43 43 43 43 43 43 43 43 43 
43 43 43 43 43 43 43 50 51 51 61 112 51 51 73 52 43 43 50 51 51 51 51 51 52 43 43 43 43 50 51 51 51 51 51 51 51 51 51 51 51 51 51 51 51 51 51 51 51 51 51 51 51 51 51 51 51 51 51 39 39 39 39 39 39 39 39 39 40 43 
43 43 43 43 43 43 43 50 51 51 49 49 51 51 51 52 43 43 50 51 51 51 51 51 52 43 43 43 43 50 51 51 51 51 51 51 51 51 112 112 51 51 51 51 51 51 51 51 51 51 51 51 51 51 51 51 51 51 51 51 51 51 51 51 51 51 51 51 52 43 
43 43 43 43 43 43 43 50 51 51 51 51 51 51 51 52 43 43 50 51 51 51 51 51 52 43 43 43 43 50 51 51 51 51 51 51 51 51 112 51 51 51 51 51 51 51 51 51 51 51 112 51 51 51 51 51 51 51 73 51 51 51 51 51 51 51 51 51 52 43 
43 43 43 43 43 43 43 50 51 51 51 51 51 51 51 52 43 43 62 63 63 63 63 63 64 43 43 43 43 50 51 51 51 51 51 51 51 51 51 51 51 51 51 51 51 51 51 51 51 51 51 51 51 51 51 51 51 51 51 51 51 51 51 51 51 51 51 51 52 43 
43 43 43 43 66 43 43 50 51 51 51 51 112 51 51 52 43 43 43 43 65 65 43 43 43 43 43 43 43 50 51 51 51 51 51 51 51 51 51 51 51 51 51 51 51 51 51 51 51 51 51 51 51 51 51 51 51 51 51 51 51 51 51 51 51 51 51 51 52 43 
43 43 43 43 66 43 43 50 51 51 51 51 112 51 51 52 43 43 43 43 65 65 43 43 43 43 43 43 43 50 51 51 51 51 51 51 51 51 51 51 51 51 51 51 51 51 51 51 51 51 51 51 51 51 51 51 51 51 51 51 51 51 51 51 51 51 51 51 52 43 
43 43 43 43 66 43 43 50 51 51 51 112 112 51 51 51 39 39 39 39 39 39 39 39 39 39 39 39 39 51 51 51 51 51 51 57 57 57 57 117 57 57 117 57 57 57 118 57 57 57 118 57 57 57 57 57 57 117 57 117 51 51 51 51 51 51 51 51 52 43 
43 43 43 43 66 43 43 50 51 51 51 112 51 51 51 51 51 51 51 51 51 51 51 51 51 51 51 51 51 51 51 51 51 51 51 118 118 57 57 57 118 57 57 57 118 57 57 57 57 57 57 57 117 57 118 57 57 57 57 118 51 51 51 51 51 51 51 51 52 43 
43 43 43 66 66 43 43 50 51 51 51 51 51 51 51 112 51 51 51 51 51 51 51 51 51 51 51 51 51 51 51 51 51 51 51 57 118 51 51 51 51 51 51 51 51 51 51 51 51 51 51 51 51 51 51 51 51 51 57 57 51 51 51 51 51 51 51 73 52 43 
43 43 43 66 43 43 43 50 51 51 51 51 51 51 51 112 51 51 51 51 51 51 51 51 51 51 51 51 51 51 51 51 51 51 51 57 57 51 51 51 51 51 51 51 51 51 51 51 51 51 51 51 51 51 51 51 51 51 57 117 51 51 51 51 51 51 51 51 52 43 
43 43 43 43 43 43 43 50 51 37 51 51 37 49 49 51 51 51 51 51 51 51 51 51 51 51 51 51 51 51 51 51 51 51 51 57 57 51 51 51 51 51 51 51 51 51 51 51 51 51 51 51 51 51 51 51 51 51 57 118 51 51 51 51 51 51 51 51 52 43 
43 43 43 43 43 43 43 50 51 61 51 51 51 61 49 51 51 51 51 51 51 51 51 51 51 51 51 51 51 51 51 51 51 51 51 117 57 51 51 51 51 51 51 51 51 51 51 51 51 51 51 51 51 51 51 51 51 51 57 117 51 51 51 112 51 51 51 51 52 43 
43 43 43 43 43 43 43 50 49 61 51 73 51 51 61 61 51 51 51 112 51 118 57 57 117 57 57 57 117 118 118 57 57 118 57 57 118 51 51 51 51 51 112 51 51 51 51 51 51 51 51 51 51 51 51 51 51 51 57 57 51 51 51 51 51 51 51 51 52 43 
43 43 43 43 43 43 43 50 61 51 51 51 51 51 37 37 49 51 51 51 51 57 117 57 57 57 57 57 57 57 57 117 57 57 67 55 118 51 51 51 51 51 51 51 51 51 51 51 51 51 51 51 51 51 51 51 51 51 51 51 51 51 51 51 51 51 51 51 52 43 
43 43 43 66 43 43 43 50 37 51 51 51 51 51 51 61 51 51 51 51 61 57 57 51 51 51 51 51 51 51 112 112 51 51 51 51 51 51 51 51 51 51 51 51 51 51 51 51 51 51 51 51 51 51 51 51 51 51 51 51 51 51 51 51 51 51 51 51 52 43 
43 43 43 66 43 43 43 50 61 51 51 51 51 51 61 61 51 51 51 61 61 117 57 51 51 51 51 51 51 51 51 51 51 51 51 51 51 51 51 51 51 51 61 61 51 51 51 51 51 51 51 51 51 51 51 112 51 51 51 51 51 51 51 51 51 51 51 51 52 43 
43 43 43 66 43 43 43 50 61 51 51 51 51 51 61 37 37 51 51 61 37 57 57 51 51 51 51 51 51 51 51 51 51 51 51 51 51 51 51 49 49 49 61 61 61 51 51 51 51 51 51 51 51 51 51 51 51 51 51 51 51 51 51 51 51 51 51 51 52 43 
43 43 43 66 43 43 43 62 63 63 63 63 63 63 63 63 63 51 51 112 61 57 117 51 51 51 51 51 51 51 51 51 51 51 51 51 51 51 51 49 61 51 51 61 61 49 37 51 61 51 51 51 51 51 51 51 51 51 51 51 51 51 51 51 51 51 51 51 52 43 
43 43 66 66 43 43 43 43 65 65 43 43 43 43 43 43 43 50 51 61 61 118 57 51 51 51 51 51 51 51 51 51 51 51 51 51 51 51 51 51 61 61 61 61 61 51 49 61 49 49 49 49 49 51 51 51 51 51 51 51 51 51 51 51 51 51 51 51 52 43 
43 43 66 43 43 43 43 43 65 65 43 43 43 43 43 43 43 50 51 51 51 118 57 51 49 61 51 63 63 63 63 63 63 51 51 51 61 51 51 49 37 51 61 49 51 49 49 61 61 61 51 51 51 51 51 51 51 51 51 51 51 51 51 51 51 51 51 51 52 43 
43 43 43 66 43 43 43 43 65 65 43 43 43 43 43 43 43 50 51 51 51 117 57 51 61 61 52 43 43 43 43 43 43 50 51 61 61 61 49 49 37 49 51 51 61 49 51 49 49 51 61 61 61 51 51 61 51 51 51 51 51 51 51 51 51 51 51 51 52 43 
43 43 43 43 43 43 43 43 65 65 43 43 43 43 43 43 43 50 51 51 51 57 67 51 51 51 52 43 43 43 43 43 43 50 51 51 61 61 61 49 37 49 49 61 61 49 51 51 49 49 61 51 51 49 51 51 51 51 51 51 51 51 51 51 51 51 51 51 52 43 
43 43 43 43 43 43 43 43 65 65 43 43 43 43 43 43 43 50 51 51 51 57 55 51 61 61 52 43 43 43 43 43 43 50 51 51 61 51 61 61 61 61 61 51 61 37 61 51 37 37 49 61 51 37 61 51 51 51 51 51 51 51 51 51 51 51 51 51 52 43 
43 43 43 38 39 39 39 39 39 39 39 39 40 43 43 43 43 50 51 51 51 117 57 51 61 61 52 43 43 43 43 43 43 50 51 51 61 49 49 51 61 51 49 51 61 61 61 61 51 51 61 51 49 51 61 61 51 51 51 51 51 51 51 51 51 51 112 51 52 43 
43 43 43 50 61 61 51 51 51 51 51 37 52 43 43 43 43 50 51 51 51 57 118 51 49 49 52 43 43 43 43 43 43 50 51 51 61 49 49 37 61 51 61 61 51 51 61 49 49 51 61 61 51 61 51 61 51 51 51 51 51 51 51 51 51 51 112 51 52 43 
43 43 43 50 61 61 51 51 51 51 51 51 52 43 43 43 43 50 61 51 51 57 57 51 37 51 52 43 43 43 43 43 43 50 51 51 51 61 49 37 61 51 51 51 49 51 61 61 51 49 49 49 61 61 61 61 49 51 51 51 51 51 51 51 51 51 51 51 52 43 
43 43 43 50 37 37 51 37 37 49 61 51 52 43 43 43 43 50 49 51 51 57 57 51 49 49 52 43 43 43 43 43 43 50 51 51 51 51 51 51 61 61 51 49 49 61 61 61 51 61 37 49 61 61 37 51 49 61 51 51 51 51 51 51 51 51 51 51 52 43 
43 43 43 50 61 61 51 61 49 61 61 51 52 43 43 43 43 50 49 61 51 57 57 51 61 51 52 43 43 66 43 43 43 50 51 51 51 51 51 51 51 51 51 51 49 49 49 49 49 51 51 61 49 49 51 51 61 61 51 51 51 51 51 51 51 51 51 51 52 43 
43 43 43 50 61 49 51 61 61 51 51 51 52 43 43 43 43 50 51 51 51 57 57 51 51 61 52 43 43 43 43 43 43 50 51 51 51 51 51 61 51 51 51 51 51 51 51 51 51 49 49 49 49 51 51 61 61 61 51 51 51 51 51 51 51 51 51 51 52 43 
43 43 43 50 51 61 61 51 61 51 73 51 52 65 65 65 65 50 37 61 51 118 118 51 51 51 52 43 43 43 43 43 43 50 51 51 51 51 51 51 51 51 51 51 61 51 51 51 51 51 51 51 51 51 51 51 49 61 51 61 51 51 51 51 51 51 51 51 52 43 
43 43 43 50 51 51 61 51 37 61 51 51 52 65 65 65 65 50 51 51 51 57 117 51 51 61 52 43 43 43 66 43 43 62 63 63 63 63 63 63 63 63 63 63 63 63 63 63 63 63 63 51 51 51 51 51 51 51 51 61 61 51 51 51 51 51 51 51 52 43 
43 43 43 50 51 51 61 49 37 61 51 51 52 43 43 43 43 50 51 37 51 57 57 51 51 61 52 43 43 43 66 43 43 43 43 43 44 45 46 43 43 43 43 43 43 43 43 65 43 43 43 50 51 51 51 51 51 51 51 51 51 51 51 51 51 51 51 51 52 43 
43 43 43 50 37 51 51 61 61 61 51 51 52 43 43 43 43 50 51 37 51 67 57 51 51 37 52 43 43 43 66 43 43 43 43 43 56 57 58 43 43 43 43 43 43 43 43 65 43 43 43 50 51 51 51 51 51 51 51 51 51 51 51 51 51 51 73 51 52 43 
43 43 43 50 51 51 37 51 51 61 51 51 52 43 43 43 43 50 51 61 51 67 117 51 51 51 52 43 43 43 43 65 65 65 65 65 68 69 70 43 43 43 43 43 43 43 43 65 43 43 43 50 51 51 51 51 51 51 51 51 51 51 51 51 51 51 51 51 52 43 
43 43 43 50 51 51 51 51 51 49 51 51 52 43 43 43 43 50 37 37 51 118 57 51 51 51 52 43 43 43 43 65 43 43 43 43 44 45 46 43 43 43 43 43 43 43 43 65 43 43 43 50 51 51 51 51 51 51 51 51 51 51 51 51 51 51 51 51 52 43 
43 43 43 50 73 51 51 51 61 61 61 51 52 43 43 43 43 50 51 37 51 117 57 51 51 51 52 43 43 43 43 65 43 43 43 43 56 118 58 43 43 43 43 43 43 43 43 65 43 43 43 50 51 51 51 51 51 51 51 51 51 51 51 51 51 51 51 51 52 43 
43 43 43 50 51 51 51 51 51 51 51 51 52 43 43 43 43 50 51 61 51 57 118 51 51 51 52 43 43 43 43 65 43 43 43 66 68 69 70 43 66 43 43 43 43 43 65 65 43 43 43 50 51 51 51 51 51 51 51 51 51 51 51 51 51 51 51 51 52 43 
43 43 43 62 63 63 63 63 63 63 63 63 64 43 43 43 43 50 51 51 51 55 57 51 51 51 52 44 45 46 44 45 46 44 45 46 44 45 46 44 45 46 44 45 46 44 45 46 44 45 46 50 51 51 51 51 51 51 51 51 51 51 51 51 51 51 51 51 52 43 
43 43 43 43 43 43 43 43 43 43 43 43 43 43 43 43 43 50 51 51 51 57 57 51 51 61 52 56 118 58 56 57 58 56 57 58 56 57 58 56 118 58 56 57 58 56 57 58 56 57 58 50 51 51 51 51 51 51 51 51 51 51 51 112 112 51 51 51 52 43 
43 43 43 43 43 43 43 43 43 43 43 43 43 43 43 43 43 50 51 51 51 57 57 51 51 61 52 68 69 70 68 69 70 68 69 70 68 69 70 68 69 70 68 69 70 68 69 70 68 69 70 50 51 51 51 51 51 51 51 51 51 51 51 51 51 51 51 51 52 43 
43 43 43 43 43 43 43 43 43 43 43 43 43 43 43 43 43 50 51 51 51 57 118 51 51 61 52 43 43 43 43 65 65 65 43 43 44 45 46 43 43 43 43 43 43 43 65 65 65 43 43 50 51 51 51 51 51 51 51 51 51 51 51 51 51 51 51 51 52 43 
43 43 43 43 43 43 43 43 43 43 43 43 43 43 43 43 43 50 51 51 51 57 57 51 51 49 52 43 43 43 43 43 43 65 43 43 56 57 58 43 43 43 43 43 43 43 43 43 65 43 43 50 51 51 51 73 51 51 51 51 51 51 51 51 51 51 51 51 52 43 
43 43 65 43 43 43 43 43 43 43 43 43 43 43 43 43 43 50 51 51 51 118 57 51 61 61 52 43 43 43 43 43 43 65 43 43 68 69 70 43 43 43 43 43 43 43 43 43 65 43 43 50 51 51 51 51 51 51 51 51 51 51 51 51 51 51 51 51 52 43 
43 43 43 43 43 43 43 43 43 43 43 43 43 43 43 43 43 50 51 51 112 57 67 51 61 51 52 43 43 43 43 43 43 65 43 43 44 45 46 43 43 43 43 43 43 43 66 43 65 43 43 50 51 51 51 51 51 51 51 51 51 51 51 51 51 51 51 51 52 43 
43 66 66 66 43 43 43 43 43 43 66 43 43 43 43 43 43 50 51 51 51 57 55 51 37 51 52 43 43 43 43 43 43 65 65 65 56 57 58 65 65 65 65 65 65 65 65 65 65 43 43 62 63 63 63 63 63 63 63 63 63 63 63 63 63 63 63 63 64 43 
66 66 43 43 43 43 43 43 66 66 66 66 43 43 43 43 43 50 51 51 51 57 57 51 51 37 52 43 43 43 43 43 43 43 43 43 68 69 70 43 43 43 66 66 66 66 43 43 43 43 43 43 43 43 43 43 43 43 43 43 44 45 46 43 43 43 43 43 43 43 
43 43 43 43 43 43 43 66 66 43 43 66 43 43 43 43 43 50 51 37 51 57 67 61 37 37 51 39 39 39 39 39 39 39 39 39 39 39 39 39 39 40 66 43 43 43 43 43 43 43 43 43 43 43 43 43 43 43 43 43 56 57 58 43 43 43 43 43 43 43 
43 43 43 43 43 43 66 66 43 43 43 66 43 43 43 43 43 50 49 49 51 57 67 61 37 51 51 51 51 51 51 51 51 51 61 61 51 61 51 61 61 52 66 66 43 43 43 43 43 43 43 43 43 43 43 43 43 43 43 43 68 69 70 66 43 43 43 43 43 43 
43 43 43 66 43 66 66 43 43 43 43 43 66 43 43 43 43 50 37 37 51 57 118 51 51 51 51 51 51 51 51 51 112 51 51 51 49 51 51 51 51 52 44 45 46 44 45 46 44 45 46 44 45 46 44 45 46 44 45 46 44 45 46 66 43 43 43 43 43 43 
43 43 43 66 43 66 43 43 43 65 43 43 66 43 43 43 43 50 51 61 51 57 118 57 57 57 117 57 57 57 57 57 57 55 117 57 57 67 57 57 57 52 56 57 58 56 118 58 56 57 58 56 57 58 56 57 58 56 118 58 56 57 58 43 43 43 43 43 43 43 
43 43 43 66 43 66 43 43 43 43 43 43 66 43 43 43 43 50 51 61 61 57 117 57 57 118 55 67 118 118 57 57 57 57 57 118 57 57 117 57 57 52 68 69 70 68 69 70 68 69 70 68 69 70 68 69 70 68 69 70 68 69 70 43 43 43 43 43 43 43 
43 43 66 66 66 66 43 43 43 43 43 43 66 43 43 43 43 50 51 51 37 51 51 51 51 51 51 51 51 51 51 51 51 51 51 51 51 51 51 51 51 52 43 43 43 43 43 43 43 43 43 43 43 43 43 43 43 43 43 43 43 43 43 43 43 65 43 43 43 43 
43 43 66 65 66 66 43 43 43 43 43 43 43 43 43 43 43 50 51 61 51 51 51 51 51 49 61 61 49 51 61 51 37 51 51 51 51 51 51 37 51 52 43 43 43 43 43 43 43 43 43 43 43 43 66 66 43 66 66 43 43 43 43 43 43 43 43 43 43 43 
43 43 66 43 43 66 43 43 66 43 43 43 43 43 43 43 43 50 51 51 51 51 51 51 51 51 51 51 51 51 61 61 37 51 49 61 61 61 61 51 51 52 43 43 43 43 43 43 43 43 43 43 43 43 66 66 66 66 43 43 43 43 43 43 43 43 43 43 43 43 
43 43 66 43 43 66 66 43 66 43 43 43 43 43 43 43 65 62 63 63 63 63 63 63 63 63 63 63 63 63 63 63 63 63 63 63 63 63 63 63 63 64 43 43 43 43 43 43 43 43 43 43 43 43 43 66 66 66 43 43 43 43 43 43 43 43 43 43 43 43 
43 43 43 66 43 43 66 66 66 43 43 43 43 43 43 43 65 43 43 43 43 43 43 43 43 43 43 43 43 43 43 43 43 43 43 43 43 43 43 43 43 43 43 43 43 43 43 43 66 66 43 43 43 43 43 43 43 66 66 66 66 43 43 43 43 43 43 43 43 43 
43 43 43 66 66 66 43 66 43 43 43 43 43 43 43 43 43 43 43 43 43 43 43 43 43 43 43 43 43 43 43 43 43 43 43 43 43 43 43 43 43 43 43 43 43 43 43 43 66 43 43 43 65 65 43 43 43 43 43 43 66 66 66 43 43 43 43 43 43 43 
43 43 43 43 43 66 66 66 43 43 43 43 43 43 43 43 43 43 43 43 43 43 43 43 43 43 43 43 43 43 43 43 43 43 43 43 43 43 43 43 43 43 43 43 43 43 43 66 66 43 43 43 43 43 43 66 43 43 43 43 43 43 43 43 43 43 43 43 43 43 
43 43 43 43 43 43 43 43 43 43 43 43 43 43 43 43 43 43 43 66 66 66 66 66 66 66 66 66 43 43 43 43 43 43 43 43 43 43 43 43 43 43 43 43 43 43 43 66 43 43 43 66 66 66 66 66 43 43 43 43 43 43 43 43 43 43 43 43 43 43 
43 43 43 43 43 43 43 43 43 43 43 43 43 43 43 43 43 43 43 43 43 43 43 43 43 43 43 66 66 66 66 66 43 43 43 43 43 43 66 43 43 43 43 43 43 43 66 66 43 43 43 43 66 66 66 43 43 43 43 43 43 65 43 43 43 43 43 43 43 43 
43 43 43 43 65 65 65 43 43 43 43 43 43 43 43 43 43 43 43 43 43 43 43 43 43 43 43 43 43 43 43 43 43 43 43 43 43 43 66 43 43 43 43 43 65 43 66 43 43 43 43 43 43 43 43 66 66 66 66 43 43 43 43 43 43 43 43 43 43 43 
43 43 43 43 43 43 43 43 43 43 43 43 43 43 43 43 43 43 43 43 43 43 43 43 43 43 43 43 43 43 43 43 43 43 43 43 43 43 43 43 43 43 43 43 43 43 66 43 43 43 43 43 43 43 43 43 43 43 43 43 43 43 43 43 43 43 43 43 43 43 